111111111111111111111111111
1C0000001111C011000010001C1
111000001111100000001000011
100000000001001000001000001
100000000000001000001000001
111111111111001000001000001
100000000000000000000000001
10C000111111111111001110001
110000111111111111001110001
100P0111110C100000011110001
1100000000010110001E0000001
111111111111111111111111111