111111111111111111111111111
1000000011110011C1001000101
111000001111100000001000001
100000000001001000001000001
100000000000001000001000001
111111111111001000001000001
100000000000000P00000000001
100000111111111111001110001
110000111111111111001110001
100001111100100000011110001
1100000000010110001000001E1
111111111111111111111111111