111111111111111111111111111
1C0000001111C011000010000C1
100000001111000000001000001
100000000001001000001000001
100000000000001000001000001
111111001111001000001000001
100000001111000000000000001
10C000111111111111001110001
100000111111111111001110001
1P000111110C000000001110E01
100000000000011000000000001
111111111111111111111111111
