111111111111111111111111111
1C00000011110011C10010C0101
111000001111100000001000001
100000000001001000001000001
100000000000001000001000001
111111111111001000001000001
1C0000000000000000000000001
100000111111111111001110001
110000111111111111001110001
1P0001111100000000011100001
1100000000010110C01C00001E1
111111111111111111111111111